UNICODE icons:

stopwatch: â±
sports medal: ğŸ…
1st place medal: ğŸ¥‡
2nd place medal: ğŸ¥ˆ
3rd place medal: ğŸ¥‰
trophy: ğŸ†
gem: ğŸ’
bell: ğŸ””
page with curl: ğŸ“ƒ
label: ğŸ·
bookmark: ğŸ”–
ledger: ğŸ“’
notebook: ğŸ““
bookmark tabs: ğŸ“‘
open file folder: ğŸ“‚
card index dividers: ğŸ—‚
calendar: ğŸ“…
tear-off calendar: ğŸ“†
spiral notepad: ğŸ—’
chart increasing: ğŸ“ˆ
bar chart: ğŸ“Š
pushpin: ğŸ“Œ
round pushpin: ğŸ“
card file box: ğŸ—ƒ
stethoscope: ğŸ©º
medical symbol: âš•
SOON arrow: ğŸ”œ
check mark button: âœ…
check mark: âœ”
cross mark: âŒ
eight-spoked asterisk: âœ³
eight-pointed star: âœ´
red circle: ğŸ”´
yellow circle: ğŸŸ¡
green circle: ğŸŸ¢
blue circle: ğŸ”µ
chequered flag: ğŸ
flag: Italy: ğŸ‡®ğŸ‡¹
flag: United Kingdom: ğŸ‡¬ğŸ‡§
